##############################
#............O.......######..#
#........#####...............#
#.......#....................#
#...O...#.......O............#
#.......#....................#
#........#####...............#
#............................#
#............................#
#.....................O......#
#............######..........#
#............................#
#............................#
#............................#
##############################
