##########################################################################
#........................................................................#
#........................................................................#
#........................................................................#
#........................................................................#
#........................................................................#
#........................................................................#
#.......................0................................................#
#........................................................................#
#........................................................................#
#........................................................................#
#........................................................................#
#..........................0.............................................#
#........................................................................#
#........................................................................#
#........................................................................#
#........................................................................#
#........................................................................#
#........................................................................#
#........................................................................#
#........................................................................#
#........................................................................#
#........................................................................#
##########################################################################