########################################
#......................................#
#......................................#
#......................................#
#..................O...................#
#......................................#
#......................................#
#......................................#
#......................................#
#...............####...................#
#......................................#
#.......................O..............#
#......................................#
#......................................#
#......................................#
#......................................#
#......................................#
#......................................#
#......................................#
########################################
