##############################
#............O...............#
#............................#
#............................#
#..............####..........#
#............................#
#............................#
#.......O....................#
#............................#
#.....................O......#
#............................#
#.............####...........#
#............................#
#............................#
##############################
