##########
#........#
#........#
#...O....#
#........#
#........#
#........#
#........#
#........#
##########