##########
#........#
#..O.....#
#........#
#........#
#........#
#........#
#..O.....#
#........#
##########