#####################################################################################################
#.................O.................................................................................#
#...................................................................................................#
#...................................................................................................#
#...................................................................................................#
#........................####......................................................O................#
#...................................................................................................#
#...........................................................................####....................#
#..................O................................................................................#
#...................................................................................................#
#...................................................................................................#
#...............................#####...............................................................#
#...................................................................................................#
#...................................................................................................#
#.....................####..........................................................................#
#...............................................O...................................................#
#...................................................................................................#
#...................................................................................................#
#...................................................................................................#
#...................................................................................................#
#...................................................................................................#
#...................................................................................................#
#...................................................................................................#
#...................................................................................................#
#...................................................................................................#
#...................................................................................................#
#...................................................................................................#
#####################################################################################################
