########################################
#......................................#
#............................O.........#
#................####..................#
#......................................#
#...............#....#.................#
#......................................#
#......................................#
#......................................#
#......................................#
#......................................#
#......................O...............#
#......................................#
#......................................#
#......................................#
#......................................#
#......................................#
#......................................#
#......................................#
########################################
